9 12 10 6
WWWWWWWWWWWWWWWWWWWWWW
WPTTTTTTTWTTTTTTTTTTTW
WTWWTWWWTWTWWWPWWTWWTW
WTWWTWWWTWTWWWTWWTWWTW
WTTTTTTTTTTTTTTTTTTTTW
WTWWTWWTWWTWWTWTWTWWTW
WTWWTTTTTTTTTTTTTTTTTW
WTTTTWWTWWTWWWWTWWWWTW
WTWWTWWTWWTWWWWTWWTTTW
WPTWTTTTTTTTTTTTTTTWWW
WWTWTWTWWWWTWTWWWWTTPW
WTTTTWTTTWTTWTTTTTTWTW
WTWWTWWWTETWWWTWWTWWTW
WTTTTTTTTTTTTTTTTTTTTW
WWWWWWWWWWWWWWWWWWWWWW
